"V1","V2","V3","V4","V5","V6","V7","V8","V9","V10","V11","V12","V13"
-9,-9,-9,-9,-9,-9,-9,-9,-9,-9,-9,-9,-9
-9,-9,-9,-9,-9,-9,-9,-9,-9,-9,-9,-9,-9
-9,-9,-9,-9,-9,-9,-9,-9,-9,-9,-9,-9,-9
-9,-9,-9,-5,-5,-5,-5,-1,-5,-5,-9,-9,-9
-9,-9,-9,-5,-5,-5,-5,-5,-5,-5,-9,-9,-9
-9,-9,-9,-5,-5,-5,-5,-5,-5,-5,-9,-9,-9
-9,-9,-9,-5,-5,-5,-5,-5,-5,-5,-9,-9,-9
-9,-9,-9,-5,-5,-5,-5,-5,-5,-5,-9,-9,-9
-9,-9,-9,-5,-5,-5,-5,-5,-5,-5,-9,-9,-9
-9,-9,-9,-9,-9,-9,-9,-9,-9,-9,-9,-9,0
-9,-9,-9,-9,-9,-9,-9,-9,-9,-9,-9,-9,1
-9,-9,-9,-9,-9,-9,-9,-9,-9,-9,-9,-9,1
